{
  "num_classes": 56,
  "model_index_to_category_id": {
    "0": 1900,
    "1": 2483,
    "2": 3351,
    "3": 3483,
    "4": 3544,
    "5": 3743,
    "6": 3832,
    "7": 4543,
    "8": 12081,
    "9": 12247,
    "10": 12778,
    "11": 13395,
    "12": 13900,
    "13": 16232,
    "14": 16262,
    "15": 16548,
    "16": 16551,
    "17": 16688,
    "18": 18147,
    "19": 18357,
    "20": 19232,
    "21": 19552,
    "22": 19607,
    "23": 19861,
    "24": 20014,
    "25": 20238,
    "26": 20877,
    "27": 21325,
    "28": 21771,
    "29": 22074,
    "30": 22347,
    "31": 22362,
    "32": 24850,
    "33": 25367,
    "34": 25438,
    "35": 25469,
    "36": 27733,
    "37": 27777,
    "38": 27926,
    "39": 27993,
    "40": 28763,
    "41": 29345,
    "42": 29451,
    "43": 29667,
    "44": 30308,
    "45": 31863,
    "46": 31885,
    "47": 32310,
    "48": 33009,
    "49": 33208,
    "50": 33880,
    "51": 34597,
    "52": 35206,
    "53": 36637,
    "54": 38162,
    "55": 41768
  },
  "category_id_to_model_index": {
    "1900": 0,
    "2483": 1,
    "3351": 2,
    "3483": 3,
    "3544": 4,
    "3743": 5,
    "3832": 6,
    "4543": 7,
    "12081": 8,
    "12247": 9,
    "12778": 10,
    "13395": 11,
    "13900": 12,
    "16232": 13,
    "16262": 14,
    "16548": 15,
    "16551": 16,
    "16688": 17,
    "18147": 18,
    "18357": 19,
    "19232": 20,
    "19552": 21,
    "19607": 22,
    "19861": 23,
    "20014": 24,
    "20238": 25,
    "20877": 26,
    "21325": 27,
    "21771": 28,
    "22074": 29,
    "22347": 30,
    "22362": 31,
    "24850": 32,
    "25367": 33,
    "25438": 34,
    "25469": 35,
    "27733": 36,
    "27777": 37,
    "27926": 38,
    "27993": 39,
    "28763": 40,
    "29345": 41,
    "29451": 42,
    "29667": 43,
    "30308": 44,
    "31863": 45,
    "31885": 46,
    "32310": 47,
    "33009": 48,
    "33208": 49,
    "33880": 50,
    "34597": 51,
    "35206": 52,
    "36637": 53,
    "38162": 54,
    "41768": 55
  }
}